### Level0
#
# All lines beginning with a '#' are ommited
# Empty lines _matter_
#
tilesize: 32
theme: bubblegold
#
level:{
xxxxxxxxxxxxxxxxxxxxxxxxxx 
xxv                     ux 
xx                       x 
xx      xxxxxxx          x 
xx                       x 
xx                      xx 
xxxxxxxxx   /xxx         x            
xx         /xx           x            
xx        /xxx           x            
xx        xxxx           xxxx         
xx   xx     ux\          x            
xx  xxx      ux\                     x 
xx    x       ux\                    x 
xx             ux\                   x 
xxxxxxxxxxxxxxxxxxxxxxxxxxxxxxxxxxxxxx 
}
