### Level0
#
# All lines beginning with a '#' are ommited
# Empty lines _matter_
#
tilesize: 32
theme: simplegrey
#
level:{
xxxxxxxxxxxxxxxxxxxxxxxxxxxxxxxxxxxxxx
xv                                  ux
x                                    x
x                                    x
x                                    x
x                                    x
x                                    x
x                                    x
x                                    x
x      xxxxxxx                       x
x                                    x
x                                    x
x                                    x
xxxxxxxx   /xxx                      x
x         /xx                        x
x        /xxx       x                x
x        xxxx                        x
x   xx      x                        x
x  xxx       x                       x
x    x        x                      x
x              x                     x
xxxxxxxxxxxxxxxxxxxxxxxxxxxxxxxxxxxxxx
}
