### Level0
#
# All lines beginning with a '#' are ommited
# Empty lines _matter_
#
tilesize: 32
theme: bubblegold
#
level:{
xxxxxxxxxxxxxxxxxxxxxxxxx
x                       x
x                       x
x      xxxxxxx          x
x                       x
x                      xx
xxxxxxxx   /xxx         x
x         /xx           x
x        /xxx           x
x        xxxx           x
x   xx     ux\          x
x  xxx      ux\         x
x    x       ux\        x
x             ux\       x
xxxxxxxxxxxxxxxxxxxxxxxxx
}
