### Level0
#
# All lines beginning with a '#' are ommited
# Empty lines _matter_
#
tilesize: 32
theme: simplegrey
#
level:{
xxxxxxxxxxxxxxxxxxxxxxxxxxxxxxxxxxxxxx
xxv                                 ux
xx                                   x
xx                                   x
xx                                   x
xx                                   x
xx                                   x
xx                                   x
xx                                   x
xx      xxxxxxx                      x
xx                                   x
xx                                   x
xx                                   x
xxxxxxxxx   /xxx                      x
x         /xx                        x
x        /xxx       x                x
x        xxxx                        x
x   xx      x                        x
x  xxx       x                       x
x    x        x                      x
x              x                     x
xxxxxxxxxxxxxxxxxxxxxxxxxxxxxxxxxxxxxx
}
